111111111111111
1000000000000E1
10000C000000111
100000000000001
1C0000000000001
100000000000001
100000000000001
100P00000000001
1000000000000C1
111111111111111