111111111111111
1000000000000E1
10000C000000101
100000000000001
1C1000000000001
1100000N0000001
100100000000001
101PN0000000001
1001000000001C1
111111111111111