111111111111
1CP000000001
100000N00001
111111111111
100000000001
100000000001
1000000000E1
111111111111