111111111111
1CP0000000E1
100000N00001
111111111111