111111111111
1CP0000000E1
111111111111