1111111111111
10P0000000011
100000N000011
1111C11111111
1000000000011
1000000000011
1000000000E11
1111111111111