111111111111111
1000000000001E1
1C00000000000N1
1000000N0000001
1P0000000000001
111111111111111
