111111111111111
10N000N000N0001
1CNCN0NCN0NCN01
10N0NCN0NCN0NC1
1P00N000N000NE1
111111111111111
